Pantherophis_obsoletusJeffersonLA	OG
Pcatenifer_SiouxNE	OG
Pcatenifer_WheelerTX	OG
Pml_JacksonMS1	ME
Pml_JacksonMS2	ME
Pml_JacksonMS3	ME
Pml_MobileAL	ME
Pml_PerryMS1	ME
Pml_PerryMS2	ME
Pml_PerryMS3	ME
Pmmel_AutaugaAL	ME
Pmmel_BakerGA	FE
Pmmel_BurlingtonNJ1	FE
Pmmel_BurlingtonNJ2	FE
Pmmel_CovingtonAL1	ME
Pmmel_CovingtonAL2	ME
Pmmel_HokeNC	FE
Pmmel_HumphreysTN	TN
Pmmel_HuntingdonTN	TN
Pmmel_MarionGA1	ME
Pmmel_MarionGA2	ME
Pmmel_OceanNJ	FE
Pmmel_PierceGA	FE
Pmmel_RichmondNC	FE
Pmmel_RockinghamNC	FE
Pmmel_ScotlandNC	FE
Pmmel_TurnerGA	FE
Pmmel_WinstonAL	ME
Pmmg_AlachuaFL	FE
Pmmg_BristolFL	ME
Pmmg_BrooksvilleFL	FE
Pmmg_CantonmentFL	ME
Pmmg_HamiltonFL	ME
Pmmg_HernandoFL	FE
Pmmg_LafayetteFL	FE
Pmmg_LibertyFL	FE
Pmmg_MarionFL	FE
Pmmg_HighlandsFL FE
Pmmg_OkeechobeeFL1	FE
Pmmg_OkeechobeeFL2	FE
Pmmg_PDLeFL	ME
Pmmg_SanRosFL	ME
Pruthveni_BienvilleLA1	OG
Pruthveni_BienvilleLA2	OG
