P.catenifer_Sioux_NE	OG
P.catenifer_Wheeler_TX	OG
P.m.l._Jackson_MS_2	One
P.m.l._Jackson_MS_3	One
P.m.l._Mobile_AL	One
P.m.l._Perry_MS_1	One
P.m.l._Perry_MS_2	One
P.m.l._Perry_MS_3	One
P.m.mel._Autauga_AL	One
P.m.mel._Baker_GA	One
P.m.mel._Burlington_NJ_1	One
P.m.mel._Burlington_NJ_2	One
P.m.mel._Covington_AL_1	One
P.m.mel._Covington_AL_2	One
P.m.mel._Hoke_NC	One
P.m.mel._Humphreys_TN	One
P.m.mel._Huntingdon_TN	One
P.m.mel._Marion_GA_1	One
P.m.mel._Marion_GA_2	One
P.m.mel._Ocean_NJ	One
P.m.mel._Pierce_GA	One
P.m.mel._Richmond_NC	One
P.m.mel._Rockingham_NC	One
P.m.mel._Scotland_NC	One
P.m.mel._Turner_GA	One
P.m.mel._Winston_AL	One
P.m.mg._Alachua_FL	One
P.m.mg._Bristol_FL	One
P.m.mg._Cantonment_FL	One
P.m.mg._Hamilton_FL	One
P.m.mg._Highlands_FL One
P.m.mg._Lafayette_FL	One
P.m.mg._Liberty_FL	One
P.m.mg._Marion_FL	One
P.m.mg._Okaloosa_FL One
P.m.mg._Okeechobee_FL_1	One
P.m.mg._Okeechobee_FL_2	One
P.m.mg._PDLe_FL	One
P.m.mg._SanRos_FL	One
P.m.mg_Hernando_FL	One
P.ruthveni_Bienville_LA_1	OG
P.ruthveni_Bienville_LA_2	OG
Pantherophis_obsoletus_Jefferson_LA	OG
