P.catenifer_Sioux_NE	OG
P.catenifer_Wheeler_TX	OG
P.m.l._Jackson_MS_2	ME
P.m.l._Jackson_MS_3	ME
P.m.l._Mobile_AL	ME
P.m.l._Perry_MS_1	ME
P.m.l._Perry_MS_2	ME
P.m.l._Perry_MS_3	ME
P.m.mel._Autauga_AL	ME
P.m.mel._Baker_GA	FE
P.m.mel._Burlington_NJ_1	FE
P.m.mel._Burlington_NJ_2	FE
P.m.mel._Covington_AL_1	ME
P.m.mel._Covington_AL_2	ME
P.m.mel._Hoke_NC	FE
P.m.mel._Humphreys_TN	ME
P.m.mel._Huntingdon_TN	ME
P.m.mel._Marion_GA_1	ME
P.m.mel._Marion_GA_2	ME
P.m.mel._Ocean_NJ	FE
P.m.mel._Pierce_GA	FE
P.m.mel._Richmond_NC	FE
P.m.mel._Rockingham_NC	FE
P.m.mel._Scotland_NC	FE
P.m.mel._Turner_GA	FE
P.m.mel._Winston_AL	ME
P.m.mg._Alachua_FL	FE
P.m.mg._Bristol_FL	ME
P.m.mg._Cantonment_FL	ME
P.m.mg._Hamilton_FL	ME
P.m.mg._Highlands_FL FE
P.m.mg._Lafayette_FL	FE
P.m.mg._Liberty_FL	FE
P.m.mg._Marion_FL	FE
P.m.mg._Okaloosa_FL ME
P.m.mg._Okeechobee_FL_1	FE
P.m.mg._Okeechobee_FL_2	FE
P.m.mg._PDLe_FL	ME
P.m.mg._SanRos_FL	ME
P.m.mg_Hernando_FL	FE
P.ruthveni_Bienville_LA_1	OG
P.ruthveni_Bienville_LA_2	OG
Pantherophis_obsoletus_Jefferson_LA	OG
