P.catenifer_Sioux_NE  OG
P.catenifer_Wheeler_TX	OG
P.ruthveni_Bienville_LA_1	OG
P.ruthveni_Bienville_LA_2	OG
Pantherophis_obsoletus_Jefferson_LA	OG
P.m.l._Jackson_MS_2	G
P.m.l._Jackson_MS_3	G
P.m.l._Mobile_AL	G
P.m.l._Perry_MS_1	G
P.m.l._Perry_MS_2	G
P.m.l._Perry_MS_3	G
P.m.mel._Baker_GA	F
P.m.mel._Covington_AL_1	F
P.m.mel._Covington_AL_2	F
P.m.mg._PDLe_FL	F
P.m.mg._SanRos_FL	F
P.m.mg._Okaloosa_FL F
P.m.mel._Autauga_AL	E
P.m.mel._Humphreys_TN	E
P.m.mel._Huntingdon_TN	E
P.m.mel._Winston_AL	E
P.m.mel._Pierce_GA	D
P.m.mel._Turner_GA	D
P.m.mg._Alachua_FL	D
P.m.mg._Highlands_FL D
P.m.mg._Lafayette_FL	D
P.m.mg._Marion_FL	D
P.m.mg._Okeechobee_FL_1	D
P.m.mg._Okeechobee_FL_2	D
P.m.mg_Hernando_FL	D
P.m.mel._Marion_GA_1	C
P.m.mel._Marion_GA_2	C
P.m.mg._Liberty_FL	C
P.m.mg._Cantonment_FL	C
P.m.mg._Hamilton_FL	C
P.m.mg._Bristol_FL	C
P.m.mel._Burlington_NJ_1	B
P.m.mel._Ocean_NJ	B
P.m.mel._Burlington_NJ_2	B
P.m.mel._Hoke_NC	A
P.m.mel._Richmond_NC	A
P.m.mel._Rockingham_NC A
P.m.mel._Scotland_NC	A
